████████████D█████████████
█           H            █
█                        █
█          $$$           █
█         $   $          █
█          $$$           █
█                        █
█                        █
█                        █
█                        █
███████████████████████████